|-----------|
|...|..-....|
|..-|.@.....|
|.....-...P.|
|..y...-....|
|.y....-....|
|-----------|